*******P*******
*******.*.....*
*...***.*****.*
*.*****...*...*
*....****.*.***
****.****...*.*
*.........***.*
*.*********...*
*.*.........***
*.*.*.***.*****
*...*.***...***
***.*.***.*.***
*.***.....*.***
*.*****.***.***
*.......***...G
